Column 1,Name,Column 2,Age,Position,Games Played,Goals,Assists,Points
20,"Duchene, Matt",,34,C,82,30,52,82
45,"Rakell, Rickard",,32,C,81,35,35,70
60,"Tuch, Alex",,29,R,82,36,31,67
57,"Kopitar, Anze",,37,C,81,21,46,67
58,"Kadri, Nazem",,34,C,82,35,32,67
61,"Hintz, Roope",,28,C,76,28,39,67
65,"Protas, Aliaksei",,24,C,76,30,36,66
63,"Granlund, Mikael",,33,C,83,22,44,66
64,"Dubois, Pierre-Luc",,27,C,82,20,46,66
68,"Rust, Bryan",,33,R,71,31,34,65
69,"Wilson, Tom",,31,R,81,33,32,65
71,"Schmaltz, Nick",,29,C,82,20,43,63
70,"Ehlers, Nikolaj",,29,L,69,24,39,63
78,"Donato, Ryan",,29,C,80,31,31,62
76,"Zibanejad, Mika",,32,C,82,20,42,62
75,"Huberdeau, Jonathan",,32,L,81,28,34,62
79,"Hertl, Tomas",,31,C,73,32,29,61
86,"Kane, Patrick",,36,R,72,21,38,59
87,"Trocheck, Vincent",,32,C,82,26,33,59
88,"Cirelli, Anthony",,28,C,80,27,32,59
91,"Knies, Matthew",,22,L,78,29,29,58
89,"Teravainen, Teuvo",,30,C,82,15,43,58
92,"Geekie, Morgan",,27,C,77,33,24,57
96,"Monahan, Sean",,30,C,54,19,38,57
99,"Buchnevich, Pavel",,30,C,76,20,37,57
97,"Horvat, Bo",,30,C,81,28,29,57
102,"Marchessault, Jonathan",,34,L,78,21,35,56
101,"Nelson, Brock",,33,C,80,26,30,56
104,"Terry, Troy",,27,C,77,21,34,55
110,"Zuccarello, Mats",,37,R,69,19,35,54
108,"Lee, Anders",,35,L,82,29,25,54
118,"McLeod, Ryan",,25,C,79,20,33,53
115,"Verhaeghe, Carter",,29,C,81,20,33,53
112,"O'Reilly, Ryan",,34,C,79,21,32,53
114,"Zucker, Jason",,33,L,73,21,32,53
116,"Meier, Timo",,28,R,80,26,27,53
113,"Karlsson, Erik",,35,D,82,11,42,53
126,"Bennett, Sam",,29,C,76,25,26,51
125,"Barbashev, Ivan",,29,C,70,23,28,51
122,"Marchand, Brad",,37,C,71,23,28,51
124,"Stephenson, Chandler",,31,C,78,13,38,51
133,"Perfetti, Cole",,23,C,82,18,32,50
130,"Garland, Conor",,29,R,81,19,31,50
127,"Malkin, Evgeni",,38,C,68,16,34,50
128,"Giroux, Claude",,37,C,81,15,35,50
129,"Schenn, Brayden",,33,C,82,18,32,50
131,"Boeser, Brock",,28,R,75,25,25,50
136,"Nugent-Hopkins, Ryan",,32,C,78,20,29,49
135,"Schwartz, Jaden",,33,L,81,26,23,49
134,"Benn, Jamie",,36,L,80,16,33,49
137,"Palmieri, Kyle",,34,R,82,24,24,48
138,"DeBrusk, Jake",,28,L,82,28,20,48
139,"Svechnikov, Andrei",,25,R,72,20,28,48
141,"Voronkov, Dmitri",,24,C,73,23,24,47
146,"Marchment, Mason",,30,L,62,22,25,47
145,"Zacha, Pavel",,28,C,82,14,33,47
143,"Weegar, MacKenzie",,31,D,81,8,39,47
144,"Lindholm, Elias",,30,C,82,17,30,47
154,"Neighbours, Jake",,23,L,82,22,24,46
151,"Suter, Pius",,29,C,81,25,21,46
152,"Hayton, Barrett",,25,C,82,20,26,46
150,"Foegele, Warren",,29,L,82,24,22,46
149,"Bjorkstrand, Oliver",,30,R,79,21,25,46
148,"Bertuzzi, Tyler",,30,L,82,23,23,46
158,"Cuylle, Will",,23,L,82,20,25,45
155,"Holmstrom, Simon",,24,R,75,20,25,45
164,"Vatrano, Frank",,31,C,81,21,24,45
163,"Lehkonen, Artturi",,30,L,69,27,18,45
157,"Lundell, Anton",,23,C,79,17,28,45
161,"Couturier, Sean",,32,C,79,15,30,45
165,"Chabot, Thomas",,28,D,80,9,36,45
169,"Kakko, Kaapo",,24,R,79,14,30,44
168,"Toews, Devon",,31,D,76,10,34,44
174,"Foerster, Tyson",,23,R,81,25,18,43
176,"Danault, Phillip",,32,C,80,8,35,43
177,"Tippett, Owen",,26,R,77,20,23,43
175,"Beniers, Matthew",,22,C,82,20,23,43
180,"Laferriere, Alex",,23,R,77,19,23,42
179,"Pageau, Jean-Gabriel",,32,C,79,14,28,42
178,"Hall, Taylor",,33,L,77,18,24,42
181,"Zetterlund, Fabian",,25,L,84,19,22,41
182,"Brink, Bobby",,24,R,79,12,29,41
184,"Noesen, Stefan",,32,R,78,22,19,41
186,"Paul, Nick",,30,L,76,22,19,41
183,"Strome, Ryan",,32,C,82,10,31,41
187,"Montour, Brandon",,31,D,81,18,23,41
197,"Sherwood, Kiefer",,30,C,78,19,21,40
194,"Howden, Brett",,27,C,80,23,17,40
188,"Dadonov, Evgenii",,36,R,80,20,20,40
192,"Grzelcyk, Matt",,31,D,82,1,39,40
193,"Walman, Jake",,29,D,65,7,33,40
195,"Moore, Trevor",,30,C,71,18,22,40
189,"Smith, Reilly",,34,R,79,13,27,40
196,"Mittelstadt, Casey",,26,C,81,15,25,40
190,"Fowler, Cam",,33,D,68,9,31,40
198,"Power, Owen",,22,D,79,7,33,40
191,"Hamilton, Dougie",,32,D,64,9,31,40
200,"Quinn, Jack",,23,R,74,15,24,39
203,"Roslovic, Jack",,28,C,81,22,17,39
201,"Coleman, Blake",,33,L,82,15,24,39
205,"Pionk, Neal",,30,D,69,10,29,39
202,"Hanifin, Noah",,28,D,80,10,29,39
204,"Dunn, Vince",,28,D,62,11,28,39
208,"Namestnikov, Vladislav",,32,C,78,11,27,38
210,"Byram, Bowen",,24,D,82,7,31,38
209,"Bunting, Michael",,29,L,76,19,19,38
206,"Gallagher, Brendan",,33,R,82,21,17,38
221,"Raddysh, Darren",,29,D,73,6,31,37
218,"Gaudreau, Frederick",,32,C,82,18,19,37
222,"Frost, Morgan",,26,C,81,14,23,37
219,"Drouin, Jonathan",,30,L,43,11,26,37
212,"Cates, Noah",,26,L,78,16,21,37
213,"Pinto, Shane",,24,C,70,21,16,37
216,"Niederreiter, Nino",,32,R,82,17,20,37
214,"Kuzmenko, Andrei",,29,L,66,11,26,37
220,"Burakovsky, Andre",,30,L,79,10,27,37
217,"Killorn, Alex",,35,L,82,19,18,37
230,"Bolduc, Zack",,22,C,72,19,17,36
224,"van Riemsdyk, James",,36,L,71,16,20,36
228,"Evans, Jake",,29,C,82,13,23,36
223,"Staal, Jordan",,36,C,75,13,23,36
225,"Martinook, Jordan",,33,C,79,15,21,36
229,"Mercer, Dawson",,23,C,82,19,17,36
226,"Parayko, Colton",,32,D,64,16,20,36
227,"Jones, Seth",,30,D,63,9,27,36
231,"Tsyplakov, Maxim",,26,R,77,10,25,35
236,"Tolvanen, Eeli",,26,R,81,23,12,35
232,"Foligno, Nick",,37,L,78,15,20,35
234,"Wennberg, Alexander",,30,C,77,10,25,35
233,"Coyle, Charlie",,33,C,83,17,18,35
235,"Norris, Joshua",,26,C,56,21,14,35
241,"Greig, Ridly",,22,C,78,13,21,34
243,"McMann, Bobby",,29,C,74,20,14,34
237,"Johansson, Marcus",,34,C,72,11,23,34
238,"Lowry, Adam",,32,C,73,16,18,34
240,"Mikheyev, Ilya",,30,R,80,20,14,34
245,"Lohrei, Mason",,24,D,77,5,28,33
246,"Sillinger, Cole",,22,C,66,11,22,33
253,"Domi, Max",,30,C,74,8,25,33
255,"Dvorak, Christian",,29,C,82,12,21,33
250,"Tarasenko, Vladimir",,33,R,80,11,22,33
244,"Kotkaniemi, Jesperi",,25,C,78,12,21,33
249,"Ekholm, Mattias",,35,D,65,9,24,33
256,"Provorov, Ivan",,28,D,82,7,26,33
251,"Skjei, Brady",,31,D,82,10,23,33
258,"Hronek, Filip",,27,D,61,5,28,33
254,"Ekblad, Aaron",,29,D,56,3,30,33
248,"Pietrangelo, Alex",,35,D,71,4,29,33
252,"Nurse, Darnell",,30,D,76,5,28,33
264,"Robinson, Eric",,30,L,82,14,18,32
266,"Olivier, Mathieu",,28,R,82,18,14,32
263,"Rodrigues, Evan",,32,C,82,15,17,32
265,"Sharangovich, Yegor",,27,C,73,17,15,32
259,"Backlund, Mikael",,36,C,76,15,17,32
262,"Compher, J.T.",,30,C,76,11,21,32
261,"Spurgeon, Jared",,35,D,66,7,25,32
269,"Edvinsson, Simon",,22,D,78,7,24,31
270,"Samoskevich, Mackie",,22,R,72,15,16,31
279,"Poehling, Ryan",,26,C,68,12,19,31
272,"Laughton, Scott",,31,C,80,13,18,31
277,"Roy, Nicolas",,28,C,71,15,16,31
278,"Iafallo, Alex",,31,L,82,15,16,31
276,"Andersson, Rasmus",,28,D,81,11,20,31
273,"Matheson, Mike",,31,D,80,6,25,31
275,"Gourde, Yanni",,33,C,57,7,24,31
274,"Forsling, Gustav",,29,D,80,11,20,31
271,"McDonagh, Ryan",,36,D,82,4,27,31
284,"Brown, Connor",,31,R,82,13,17,30
280,"Perry, Corey",,40,R,81,19,11,30
286,"Kolesar, Keegan",,28,R,82,12,18,30
283,"Saad, Brandon",,32,L,72,13,17,30
288,"Sandin, Rasmus",,25,D,82,4,26,30
289,"Vlasic, Alex",,24,D,82,4,26,30
287,"Gavrikov, Vladislav",,29,D,82,5,25,30
281,"Letang, Kris",,38,D,74,9,21,30
285,"Sanheim, Travis",,29,D,82,8,22,30
282,"Kreider, Chris",,34,L,68,22,8,30
292,"Faber, Brock",,22,D,78,10,19,29
300,"Olofsson, Victor",,30,L,56,15,14,29
290,"Kesselring, Michael",,25,D,82,7,22,29
302,"Heinen, Danton",,30,L,79,9,20,29
296,"Skinner, Jeff",,33,C,72,16,13,29
297,"Armia, Joel",,32,R,81,11,18,29
294,"Ekman-Larsson, Oliver",,34,D,77,4,25,29
295,"Foligno, Marcus",,33,L,77,14,15,29
303,"Colton, Ross",,28,C,61,16,13,29
299,"Pettersson, Marcus",,29,D,78,4,25,29
291,"Broberg, Philip",,24,D,68,8,21,29
301,"Eriksson Ek, Joel",,28,C,46,14,15,29
298,"Karlsson, William",,32,C,53,9,20,29
293,"Burns, Brent",,40,D,82,6,23,29
313,"Benson, Zach",,20,L,75,10,18,28
311,"Krebs, Peyton",,24,C,81,10,18,28
312,"Spence, Jordan",,24,D,79,4,24,28
309,"Stenlund, Kevin",,28,C,82,14,14,28
305,"Nyquist, Gustav",,35,C,79,11,17,28
308,"Kerfoot, Alexander",,30,C,81,11,17,28
306,"Larsson, Adam",,32,D,82,7,21,28
310,"Mangiapane, Andrew",,29,C,81,14,14,28
307,"Palat, Ondrej",,34,L,77,15,13,28
304,"Orlov, Dmitry",,34,D,76,6,22,28
319,"Pearson, Tanner",,32,L,78,12,15,27
316,"Zary, Connor",,23,C,54,13,14,27
324,"Raddysh, Taylor",,27,R,80,7,20,27
318,"Dowd, Nic",,35,C,82,14,13,27
315,"McBain, Jack",,25,C,82,13,14,27
322,"Amadio, Michael",,29,C,72,11,16,27
317,"Henrique, Adam",,35,C,81,12,15,27
314,"Miller, K'Andre",,25,D,74,7,20,27
323,"Arvidsson, Viktor",,32,L,67,15,12,27
321,"Slavin, Jaccob",,31,D,80,6,21,27
320,"Anderson, Josh",,31,R,81,15,12,27
329,"Gaudette, Adam",,28,C,81,19,7,26
326,"Blueger, Teddy",,30,C,82,8,18,26
330,"Fabbro, Dante",,27,D,68,9,17,26
332,"Newhook, Alex",,24,C,82,15,11,26
328,"Hartman, Ryan",,30,R,69,11,15,26
331,"Chytil, Filip",,25,C,56,13,13,26
325,"Eberle, Jordan",,35,R,42,9,17,26
327,"Lindell, Esa",,31,D,80,5,21,26
337,"Turcotte, Alex",,24,C,68,9,16,25
341,"Evans, Ryker",,23,D,73,5,20,25
339,"O'Connor, Drew",,27,L,84,10,15,25
336,"Pospisil, Martin",,25,C,81,4,21,25
338,"Hoglander, Nils",,24,L,72,8,17,25
346,"Steel, Sam",,27,C,79,6,19,25
344,"Beauvillier, Anthony",,28,C,81,15,10,25
335,"Fehervary, Martin",,25,D,81,5,20,25
343,"Kulak, Brett",,31,D,82,7,18,25
345,"Carrier, Alexandre",,28,D,79,3,22,25
334,"Farabee, Joel",,25,L,81,11,14,25
342,"Severson, Damon",,30,D,70,6,19,25
353,"Berggren, Jonatan",,25,R,75,12,12,24
355,"Tomasino, Philip",,24,C,61,11,13,24
354,"Podkolzin, Vasily",,24,R,82,8,16,24
348,"Myers, Tyler",,35,D,71,6,18,24
352,"Luostarinen, Eetu",,26,C,80,9,15,24
349,"Ceci, Cody",,31,D,85,4,20,24
356,"Anderson, Mikey",,26,D,77,6,18,24
351,"Girard, Samuel",,27,D,73,3,21,24
350,"Roy, Matt",,30,D,69,3,21,24
359,"Kiviranta, Joel",,29,L,79,16,7,23
358,"Boqvist, Jesper",,26,C,78,12,11,23
361,"McCabe, Jake",,31,D,66,2,21,23
363,"Copp, Andrew",,31,C,56,10,13,23
362,"Pulock, Ryan",,30,D,74,5,18,23
360,"Hayes, Kevin",,33,C,64,13,10,23
364,"McAvoy, Charlie",,27,D,50,7,16,23
375,"Brazeau, Justin",,27,R,76,11,11,22
374,"Cotter, Paul",,25,C,79,16,6,22
377,"Robertson, Nicholas",,23,L,69,15,7,22
378,"Reichel, Lukas",,23,C,70,8,14,22
370,"Appleton, Mason",,29,C,71,10,12,22
365,"Eller, Lars",,36,C,80,10,12,22
369,"Mikkola, Niko",,29,D,76,6,16,22
373,"Glass, Cody",,26,C,65,6,16,22
366,"Dumoulin, Brian",,33,D,80,3,19,22
376,"Dach, Kirby",,24,C,57,10,12,22
371,"Tanev, Brandon",,33,L,79,10,12,22
368,"Novak, Thomas",,28,C,54,13,9,22
372,"Lindgren, Ryan",,27,D,72,4,18,22
367,"Zadorov, Nikita",,30,D,81,4,18,22
379,"O'Connor, Logan",,28,R,80,10,11,21
381,"Danforth, Justin",,32,R,61,9,12,21
391,"Duhaime, Brandon",,28,R,82,9,12,21
380,"Schneider, Braden",,23,D,80,6,15,21
389,"Hathaway, Garnet",,33,R,67,10,11,21
388,"Middleton, Jacob",,29,D,67,8,13,21
385,"Sissons, Colton",,31,C,72,7,14,21
387,"van Riemsdyk, Trevor",,34,D,82,1,20,21
383,"Haula, Erik",,34,L,69,11,10,21
392,"Rasmussen, Michael",,26,C,77,11,10,21
382,"Jensen, Nick",,34,D,71,3,18,21
390,"Cernak, Erik",,28,D,76,3,18,21
386,"Pelech, Adam",,30,D,60,0,21,21
384,"Seguin, Tyler",,33,C,20,9,12,21
394,"Carrick, Sam",,33,C,80,6,14,20
400,"Samberg, Dylan",,26,D,60,6,14,20
398,"Sundqvist, Oskar",,31,C,67,6,14,20
397,"Seeler, Nick",,32,D,77,3,17,20
393,"McNabb, Brayden",,34,D,82,5,15,20
396,"Edmundson, Joel",,32,D,73,6,14,20
395,"Brodin, Jonas",,32,D,50,4,16,20
401,"Romanov, Alexander",,25,D,64,4,16,20
402,"Bahl, Kevin",,25,D,73,3,17,20
403,"Kovalenko, Nikolai",,25,R,57,7,13,20
404,"Lizotte, Blake",,27,C,59,11,9,20
405,"Drysdale, Jamie",,23,D,70,7,13,20
406,"Goncalves, Gage",,24,C,60,8,12,20
407,"Zellweger, Olen",,21,D,62,7,13,20
408,"Perbix, Nicklaus",,27,D,74,6,13,19
409,"Holmberg, Pontus",,26,C,68,7,12,19
410,"Kelly, Parker",,26,L,80,8,11,19
411,"Pelletier, Jakob",,24,L,48,7,12,19
412,"Doan, Josh",,23,R,51,7,12,19
413,"Lilleberg, Emil",,24,D,76,1,18,19
414,"Mintyukov, Pavel",,21,D,68,5,14,19
415,"Maroon, Pat",,37,L,68,5,14,19
416,"Bjugstad, Nick",,33,C,66,8,11,19
417,"Murphy, Connor",,32,D,68,2,17,19
418,"Jenner, Boone",,32,C,26,7,12,19
419,"Demelo, Dylan",,32,D,82,3,16,19
420,"Schmidt, Nate",,34,D,80,5,14,19
421,"Ristolainen, Rasmus",,30,D,63,4,15,19
422,"Brodzinski, Jonny",,32,C,51,12,7,19
424,"Lorentz, Steven",,29,C,80,8,11,19
425,"Carcone, Michael",,29,C,53,7,12,19
426,"Smith, Craig",,35,C,59,9,9,18
427,"Tanev, Christopher",,35,D,75,3,15,18
428,"Maatta, Olli",,31,D,77,2,16,18
429,"Gustafsson, Erik",,33,D,60,2,16,18
430,"Janmark, Mattias",,32,C,80,2,16,18
431,"Crouse, Lawson",,28,L,81,12,6,18
432,"Chatfield, Jalen",,29,D,79,7,11,18
433,"Kunin, Luke",,27,C,75,11,7,18
434,"Toropchenko, Alexei",,26,R,80,4,14,18
435,"Drury, Jack",,25,C,72,8,10,18
436,"Maccelli, Matias",,24,L,55,8,10,18
437,"Chaffee, Mitchell",,27,R,66,12,6,18
438,"Guhle, Kaiden",,23,D,55,6,12,18
439,"Heineman, Emil",,23,L,62,10,8,18
440,"Balinskis, Uvis",,29,D,76,4,14,18
441,"Ferraro, Mario",,26,D,78,5,12,17
442,"Kovacevic, Johnathan",,28,D,81,1,16,17
443,"Koepke, Cole",,27,L,73,10,7,17
444,"Blackwell, Colin",,32,C,63,6,11,17
445,"York, Cameron",,24,D,66,4,13,17
446,"Leason, Brett",,26,R,62,5,12,17
447,"Svechkov, Fyodor",,22,C,52,8,9,17
448,"Doughty, Drew",,35,D,30,4,13,17
449,"Cole, Ian",,36,D,82,1,16,17
450,"Tatar, Tomas",,34,L,74,7,10,17
451,"Cizikas, Casey",,34,C,82,7,10,17
452,"Oleksiak, Jamie",,32,D,82,4,13,17
453,"Kuraly, Sean",,32,C,82,6,11,17
454,"Jankowski, Mark",,30,C,60,12,5,17
455,"Pesce, Brett",,30,D,72,3,14,17
456,"Greer, A.J.",,28,L,81,6,11,17
457,"Peeke, Andrew",,27,D,76,1,16,17
458,"Aston-Reese, Zach",,31,C,79,6,11,17
459,"Liljegren, Timothy",,26,D,68,6,11,17
460,"Perron, David",,37,L,43,9,7,16
461,"Bogosian, Zach",,35,D,81,4,12,16
462,"Gudas, Radko",,35,D,81,1,15,16
463,"Dillon, Brenden",,34,D,82,2,14,16
464,"Dickinson, Jason",,30,C,59,7,9,16
465,"Walker, Nathan",,31,L,73,8,8,16
466,"Fabbri, Robby",,29,C,44,8,8,16
467,"Eyssimont, Michael",,28,C,77,9,7,16
468,"Vaakanainen, Urho",,26,D,51,2,14,16
469,"Back, Oskar",,25,C,73,4,12,16
470,"Clifton, Connor",,30,D,73,1,15,16
471,"Walker, Sean",,30,D,82,5,11,16
472,"Parssinen, Juuso",,24,C,48,6,10,16
473,"Blankenburg, Nick",,27,D,60,4,12,16
474,"Timmins, Conor",,26,D,68,3,12,15
475,"Barron, Morgan",,26,C,74,8,7,15
476,"Lundestrom, Isac",,25,C,79,4,11,15
477,"Engvall, Pierre",,29,L,62,8,7,15
478,"Zamula, Yegor",,25,D,63,3,12,15
479,"Chinakhov, Yegor",,24,C,30,7,8,15
480,"L'Heureux, Zachary",,22,L,62,5,10,15
481,"Malinski, Sam",,27,D,76,5,10,15
482,"Suter, Ryan",,40,D,82,2,13,15
483,"Savard, David",,34,D,75,1,14,15
484,"Cousins, Nick",,32,C,50,6,9,15
485,"Manson, Josh",,33,D,48,1,14,15
486,"Miller, Colin",,32,D,60,4,11,15
487,"Faksa, Radek",,31,C,70,5,10,15
488,"Trenin, Yakov",,28,C,76,7,8,15
489,"Borgen, William",,28,D,84,5,10,15
490,"Frederic, Trent",,27,C,58,8,7,15
491,"Trouba, Jacob",,31,D,77,1,13,14
492,"McCarron, Michael",,30,R,74,5,9,14
493,"Vrana, Jakub",,29,L,39,9,5,14
494,"Kapanen, Kasperi",,29,R,67,6,8,14
495,"Joshua, Dakota",,29,L,57,7,7,14
496,"Joseph, Mathieu",,28,R,60,4,10,14
497,"Marino, John",,28,D,35,1,13,14
498,"Stanley, Logan",,27,D,63,1,13,14
499,"Lyubushkin, Ilya",,31,D,80,1,13,14
500,"Boqvist, Adam",,25,D,35,4,10,14
501,"Samuelsson, Mattias",,25,D,62,4,10,14
502,"Kurashev, Philipp",,25,C,51,7,7,14
503,"Sturm, Nico",,30,C,62,7,7,14
504,"Kastelic, Mark",,26,C,61,5,9,14
505,"Moser, Janis Jérôme",,25,D,54,2,12,14
506,"Geekie, Conor",,21,R,52,8,6,14
507,"Whitecloud, Zach",,28,D,74,4,9,13
508,"Emberson, Ty",,25,D,76,2,11,13
509,"Jeannot, Tanner",,28,L,67,7,6,13
510,"Struble, Jayden",,23,D,56,2,11,13
511,"Helleson, Drew",,24,D,56,4,9,13
512,"Zub, Artyom",,29,D,56,2,11,13
513,"Barron, Justin",,23,D,62,6,7,13
514,"Kartye, Tye",,24,C,63,6,7,13
516,"Pacioretty, Max",,36,L,37,5,8,13
517,"Kulikov, Dmitry",,34,D,70,4,9,13
518,"Chiarot, Ben",,34,D,81,4,9,13
519,"Soucy, Carson",,31,D,75,4,9,13
520,"Lomberg, Ryan",,30,L,80,3,10,13
521,"Kampf, David",,30,C,59,5,8,13
522,"Lewis, Trevor",,38,C,60,6,6,12
523,"Martinez, Alec",,38,D,44,5,7,12
524,"Carlo, Brandon",,28,D,83,1,11,12
525,"Acciari, Noel",,33,C,79,5,7,12
526,"Labanc, Kevin",,29,R,34,2,10,12
527,"Hague, Nicolas",,26,D,68,5,7,12
528,"Chisholm, Declan",,25,D,66,2,10,12
529,"Pachal, Brayden",,26,D,76,3,9,12
530,"Thrun, Henry",,24,D,60,2,10,12
531,"Smith, Cole",,29,L,71,4,8,12
532,"Holtz, Alexander",,23,R,53,4,8,12
533,"Colangelo, Sam",,23,R,32,10,2,12
534,"Khusnutdinov, Marat",,23,C,75,5,7,12
535,"Texier, Alexandre",,25,C,31,6,5,11
536,"Durzi, Sean",,26,D,30,4,7,11
537,"Lauko, Jakub",,25,C,56,5,6,11
538,"MacLean, Kyle",,26,C,81,4,7,11
539,"Beecher, John",,24,C,78,3,8,11
540,"Jones, Zachary",,24,D,46,1,10,11
541,"Soderblom, Elmer",,24,L,26,4,7,11
542,"Räty, Aatu",,22,C,33,7,4,11
543,"Poitras, Matthew",,21,C,33,1,10,11
544,"Graf, Collin",,22,R,33,5,6,11
545,"Forbort, Derek",,33,D,54,2,9,11
546,"Duclair, Anthony",,30,C,44,7,4,11
547,"Carrier, William",,30,L,43,4,7,11
548,"Dumba, Matt",,31,D,63,1,9,10
549,"Oesterle, Jordan",,33,D,37,4,6,10
550,"Bastian, Nathan",,27,R,59,4,6,10
551,"Malenstyn, Beck",,27,L,76,4,6,10
552,"Rooney, Kevin",,32,C,70,5,5,10
553,"Jokiharju, Henri",,26,D,60,3,7,10
554,"Dewar, Connor",,26,C,48,4,6,10
555,"Benoit, Simon",,26,D,78,1,9,10
556,"Korczak, Kaedan",,24,D,40,0,10,10
557,"Kleven, Tyler",,23,D,79,4,6,10
558,"Thompson, Jack",,23,D,31,4,6,10
559,"Johansson, Albert",,24,D,61,3,6,9
560,"Edstrom, Adam",,24,C,51,5,4,9
562,"Miromanov, Daniil",,28,D,44,2,7,9
563,"Bichsel, Lian",,21,D,38,4,5,9
564,"Gatcomb, Marc",,26,C,39,8,1,9
565,"Atkinson, Cam",,36,R,39,4,5,9
566,"Mayfield, Scott",,32,D,66,3,6,9
567,"Motte, Tyler",,30,C,55,4,5,9
568,"Nosek, Tomas",,32,L,59,1,8,9
569,"Siegenthaler, Jonas",,28,D,55,2,7,9
570,"Hanley, Joel",,34,D,53,2,7,9
571,"Jost, Tyson",,27,C,39,4,5,9
572,"Grundstrom, Carl",,27,L,56,3,6,9
573,"Mahura, Josh",,27,D,64,0,9,9
574,"Rutta, Jan",,35,D,54,3,6,9
575,"Petry, Jeff",,37,D,44,1,7,8
576,"de Haan, Calvin",,34,D,47,0,8,8
577,"Holl, Justin",,33,D,73,2,6,8
578,"McGinn, Brock",,31,L,26,4,4,8
579,"Vesey, Jimmy",,32,L,43,5,3,8
580,"Wood, Miles",,29,L,37,4,4,8
581,"Goodrow, Barclay",,32,C,77,5,3,8
582,"Kirkland, Justin",,29,C,21,2,6,8
583,"Greenway, Jordan",,28,L,34,3,5,8
584,"Moverare, Jacob",,26,D,49,1,7,8
585,"Dellandrea, Ty",,25,C,68,1,7,8
586,"Kupari, Rasmus",,25,C,59,5,3,8
587,"Bernard-Docker, Jacob",,25,D,40,2,6,8
588,"Christiansen, Jake",,25,D,68,1,7,8
589,"Schwindt, Cole",,24,R,42,1,7,8
590,"Lapierre, Hendrix",,23,C,27,0,8,8
591,"Kaiser, Wyatt",,23,D,57,4,4,8
592,"Rempe, Matt",,23,R,42,3,5,8
593,"Allan, Nolan",,22,D,43,1,7,8
594,"Casey, Seamus",,21,D,14,4,4,8
595,"Ivan, Ivan",,23,C,40,5,3,8
596,"Kostin, Klim",,26,R,35,1,6,7
597,"Bryson, Jacob",,27,D,48,0,7,7
598,"Tucker, Tyler",,25,D,38,3,4,7
599,"Pyyhtia, Mikael",,23,L,47,4,3,7
600,"Helenius, Samuel",,22,C,50,4,3,7
601,"Schenn, Luke",,35,D,76,1,6,7
602,"Jarnkrok, Calle",,33,C,19,1,6,7
603,"Dowling, Justin",,34,C,52,2,5,7
604,"Hamonic, Travis",,35,D,59,1,6,7
605,"Lindholm, Hampus",,31,D,17,3,4,7
606,"Mantha, Anthony",,30,R,13,4,3,7
607,"Glendening, Luke",,36,C,77,4,3,7
608,"Fleury, Haydn",,29,D,39,0,7,7
609,"Lafferty, Sam",,30,C,60,4,3,7
610,"Fischer, Christian",,28,R,46,1,6,7
611,"Sprong, Daniel",,28,R,30,2,5,7
612,"Wotherspoon, Parker",,28,D,55,1,6,7
613,"Stecher, Troy",,31,D,66,3,4,7
614,"Bean, Jake",,27,D,64,2,5,7
615,"Gregor, Noah",,27,L,52,4,3,7
616,"Johnson, Jack",,38,D,41,0,6,6
617,"Merrill, Jon",,33,D,70,2,4,6
618,"Smith, Brendan",,36,D,32,1,5,6
619,"Girgensons, Zemgus",,31,C,82,2,4,6
620,"Harkins, Jansen",,28,C,62,2,4,6
621,"Gilbert, Dennis",,28,D,29,0,6,6
622,"Gustafsson, David",,25,C,36,2,4,6
623,"Karlsson, Linus",,25,R,23,3,3,6
624,"Aman, Nils",,25,C,19,1,5,6
625,"Morrow, Scott",,22,D,14,1,5,6
626,"Xhekaj, Arber",,24,D,70,1,5,6
627,"Klapka, Adam",,24,R,28,4,2,6
628,"Nyman, Jani",,21,R,12,3,3,6
630,"Lundkvist, Nils",,25,D,39,0,5,5
631,"Harris, Jordan",,25,D,33,1,4,5
632,"Minten, Fraser",,21,C,21,3,2,5
633,"Öhgren, Liam",,21,L,24,2,3,5
634,"Rinzel, Sam",,21,D,9,0,5,5
635,"Johnson, Erik",,37,D,36,2,3,5
636,"Leddy, Nick",,34,D,31,2,3,5
637,"Lazar, Curtis",,30,C,48,2,3,5
638,"Kylington, Oliver",,28,D,19,1,4,5
639,"Shea, Ryan",,28,D,39,2,3,5
640,"Abols, Rodrigo",,29,C,22,2,3,5
641,"Valimaki, Juuso",,26,D,43,2,3,5
642,"Gudbranson, Erik",,33,D,16,0,4,4
643,"Klingberg, John",,33,D,11,1,3,4
644,"Graves, Ryan",,30,D,61,1,3,4
645,"Johnston, Ross",,31,L,43,1,3,4
646,"Gadjovich, Jonah",,26,L,42,4,0,4
647,"Kaliyev, Arthur",,24,R,14,3,1,4
648,"Crevier, Louis",,24,D,32,3,1,4
649,"Mailloux, Logan",,22,D,7,2,2,4
652,"Matinpalo, Nikolas",,26,D,41,1,3,4
653,"Joseph, Pierre-Olivier",,26,D,47,0,3,3
654,"Kessel, Matthew",,25,D,29,0,3,3
655,"Jiricek, David",,21,D,12,1,2,3
656,"Pettersson, Elias",,21,D,28,1,2,3
657,"Deslauriers, Nicolas",,34,L,31,2,1,3
658,"Watson, Austin",,33,R,13,3,0,3
659,"Nieto, Matt",,32,L,32,1,2,3
660,"Burroughs, Kyle",,30,D,33,0,3,3
661,"Englund, Andreas",,29,D,35,1,2,3
662,"Stephens, Mitchell",,28,C,28,1,2,3
663,"Hunt, Dryden",,29,L,5,0,3,3
664,"Desharnais, Vincent",,29,D,51,0,3,3
665,"Reaves, Ryan",,38,R,35,0,2,2
666,"Bortuzzo, Robert",,36,D,17,0,2,2
667,"Martin, Matt",,36,L,32,0,2,2
668,"McIlrath, Dylan",,33,D,17,0,2,2
669,"Reilly, Mike",,32,D,18,0,2,2
670,"Hutton, Ben",,32,D,11,0,2,2
671,"O'Brien, Liam",,31,L,28,0,2,2
672,"Aube-Kubel, Nicolas",,29,R,22,1,1,2
673,"Hayden, John",,30,R,20,1,1,2
674,"Middleton, Keaton",,27,D,41,0,2,2
675,"Kapanen, Oliver",,22,C,18,0,2,2
676,"Korchinski, Kevin",,21,D,16,1,1,2
678,"Wiesblatt, Ozzy",,23,C,5,0,1,1
679,"Gushchin, Danil",,23,L,12,0,1,1
680,"Sourdif, Justin",,23,R,1,1,0,1
681,"Kiersted, Matt",,27,D,2,0,1,1
682,"Savoie, Matthew",,21,C,4,0,1,1
684,"Wood, Matthew",,20,L,6,0,1,1
685,"Lauzon, Jeremy",,28,D,28,0,1,1
686,"Petrovic, Alexander",,33,D,5,0,0,0
687,"Hakanpaa, Jani",,33,D,2,0,0,0
688,"Toninato, Dominic",,31,C,5,0,0,0
689,"MacDermid, Kurtis",,31,L,23,0,0,0
690,"Milano, Sonny",,29,L,3,0,0,0
691,"Juulsen, Noah",,28,D,35,0,0,0
692,"Alexeyev, Alexander",,25,D,8,0,0,0
693,"Felhaber, Tye",,27,L,5,0,0,0
694,"Robertson, Matthew",,24,D,2,0,0,0
695,"Bordeleau, Thomas",,23,C,1,0,0,0
696,"Sebrango, Donovan",,23,D,2,0,0,0
697,"Luneau, Tristan",,21,D,6,0,0,0